10 8
999	999	999	999	999	999	999	999	999	999
999	1   1	1	1	1	999	1	1	999
999	1   1	1	1	1	999	1	1	999
999	1   1	1	1	1	999	999	1	999
999	1   1	1	1	1	1	1	1	999
999	1   1	1	1	1	1	1	1	999
999	1   1	1	1	1	1	1	1	999
999	999	999	999	999	999	999	999	999	999
7 2
3 5